#############
############# 
##.$  @  $.##
#############
#############